~~~~~~~~~~
~PZZZZZZZ~
~ZZZZZZZZ~
~ZZZZZZZZ~
~ZZZZZZZZ~
~~~~~~~~~~