.....................................................
..........ZZZZZZZZ...................................
..........ZZZZZZZZ...................................
..........ZZZZZZZZ...................................
..........ZZZZZZZZ...................................
..........ZZZZZZZZ.....................ZZZZZZZZ......
..........ZZZZZZZZ.....................ZZZZZZZZ......
..........ZZZZZZZZ.....................ZZZZZZZZ......
..........ZZZZZZZZ.....................ZZZZZZZZ......
..........ZZZZZZZZ...................................
..........ZZZZZZZZ...................................
..........ZZZZZZZZ...................................
..........ZZZZZZZZ...................................
..........ZZZZZZZZ...................................
..........ZZZZZZZZ...................................
..........ZZZZZZZZ...................................
..........ZZZZZZZZ...................................
..........ZZZZZZZZ...................................
..........ZZZZZZZZ...................................
..........ZZZZZZZZ...................................
..........ZZZZZZZZ......P............................
..........ZZZZZZZZ...................................
..........ZZZZZZZZ...................................
..........ZZZZZZZZ...................................
..........ZZZZZZZZ...................................
..........ZZZZZZZZ...................................
..........ZZZZZZZZ...................................
..........ZZZZZZZZ...................................
..........ZZZZZZZZ...................................
..........ZZZZZZZZ...........................ZZZZZZZZ
..........ZZZZZZZZ...........................ZZZZZZZZ
..........ZZZZZZZZ...........................ZZZZZZZZ
..........ZZZZZZZZ...........................ZZZZZZZZ
..........ZZZZZZZZ...........................ZZZZZZZZ
..........ZZZZZZZZ...........................ZZZZZZZZ
..........ZZZZZZZZ...........................ZZZZZZZZ
..........ZZZZZZZZ...........................ZZZZZZZZ
..........ZZZZZZZZ...........................ZZZZZZZZ
..........ZZZZZZZZ...........................ZZZZZZZZ
..........ZZZZZZZZ...........................ZZZZZZZZ
..........ZZZZZZZZ...........................ZZZZZZZZ
..........ZZZZZZZZ...................................
..........ZZZZZZZZ...................................
..........ZZZZZZZZ...................................